
w - wall
b - box not yet on goal square
B - box on goal square
s - sokoban not on goal square
S - sokoban on goal square
g - goal square
  - empty

LEVEL 1 (b - 4)

wwwwwwwwwwwwwww
w     		  w
w        	  w
w      b      w
w             w
wg           gw
w      b      w
w      s      w
w      b      w
wg           gw
w             w
w      b      w
w             w
w             w 
wwwwwwwwwwwwwww

LEVEL 2 (b - 6)

wwwwwwwwwwwwwww
w    gw		  w
w     w   	  w
wg    wbb     w
www   w       w
w            gw
w      b      w
w    wwsww    w
w      b      w
wg            w
w       w   www
w     bbw    gw
w       w     w
w       wg    w 
wwwwwwwwwwwwwww


LEVEL 3 (b - 7)

wwwwwwwwwwwwwww
w     w	   gw w
w     w    gw w
w     w   www w
wwwwwww    gw w
w  g  w 	w w
w    bwb    www
w    b s     gw
w   b  b   wwww
wwwwb      w  w
w  w    b  w  w
w  w    b w   w
wg        w   w
w  w     gw   w 
wwwwwwwwwwwwwww


LEVEL 4 (b - 8)

wwwwwwwwwwwwwww
w     wg   gw w
w     w    gw w
w  wwww   www w
www         w w
w   b w	  b w w
wgggb wb wwwwww
w     ws     gw
w  b  w    wwww
wwwww    b w  w
w g w  bwwww  w
w   w   b w   w
ww        w   w
w     wwwww   w 
wwwwwwwwwwwwwww

LEVEL 5 (b - 10)

wwwwwwwwwwwwwww
w  g  bb   g  w
w  w  w    g  w
w   wwwg gwww w
wwww  b     w w
w b   w	  b w w
w    wwb wwwwww
w gw   s  wg  w
wgw    w  ww  w
ww  w b w    gw
w g w       www
w b w w b ww  w
w b b w   w   w
w     wwwww   w 
wwwwwwwwwwwwwww
